6 6 6 6 6 6 6 6 6 6 6 6 6 6 6 6
6 7 0 0 0 6 0 7 0 6 0 0 0 6 7 6
6 3 3 0 0 6 0 0 0 6 0 6 0 0 0 6
6 0 0 0 0 6 0 0 0 6 0 6 6 6 6 6
6 0 0 0 0 0 6 0 3 6 0 0 0 0 0 6
0 0 0 0 0 0 0 6 0 0 0 0 0 0 0 6
0 0 0 0 0 0 0 0 0 0 0 0 0 0 0 6
6 6 6 6 0 0 0 7 0 0 0 0 0 6 3 6
6 0 0 0 0 0 0 0 0 0 0 0 6 0 3 6
6 0 7 0 0 0 6 0 6 0 0 6 0 0 0 6
6 0 0 0 0 0 6 7 6 0 3 0 0 7 0 6
6 6 6 6 6 6 6 6 6 6 6 6 6 6 6 6 


