1 1 1 1 1 1 1 1 1 1 1 1 1 1 1 1
2 0 0 1 0 0 0 0 0 0 0 0 1 0 0 1
8 8 9 1 0 5 8 8 8 8 8 9 1 5 9 1
1 5 9 1 0 5 9 0 0 0 5 9 1 5 9 1
1 5 9 1 0 5 9 0 0 0 5 9 1 5 9 1
1 5 9 1 0 5 9 0 0 0 5 9 1 5 9 1
1 5 9 1 0 5 9 0 0 0 5 9 1 5 9 1
1 5 9 0 0 5 9 0 0 0 5 9 1 5 9 1
1 5 8 8 8 8 9 0 0 0 5 9 1 5 9 1
1 0 0 1 0 0 0 0 0 0 5 9 0 5 9 1
1 0 0 1 0 0 0 0 0 0 5 8 8 8 9 1
1 1 1 1 1 1 1 1 1 1 1 1 1 1 1 1


